######################################
######################################
######################################
######################################
######################################
######################################
######################################
######################################
######################################
######################################
######################################
######################################
######################################
######################################
######################################
######################################

+_+_+_+_+_+|             |+_+_+_+_+_+_
+_+_+_+_+_+|             |_+_+_+_+_+_+
+_+_+_+_+_+|             |_+_+_+_+_+_+
+_+_+_+_+_+|             |_+_+_+_+_+_+
+_+_+_+_+_+|             |_+_+_+_+_+_+
+_+_+_+_+_+|             |_+_+_+_+_+_+
+_+_+_+_+_+|             |_+_+_+_+_+_+
+_+_+_+_+_+|             |_+_+_+_+_+_+
+_+_+_+_+_+|             |_+_+_+_+_+_+
+_+_+_+_+_+|             |_+_+_+_+_+_+
+_+_+_+_+_+|             |_+_+_+_+_+_+
+_+_+_+_+_+|             |_+_+_+_+_+_+
+_+_+_+_+_+|             |_+_+_+_+_+_+
+_+_+_+_+_+|             |_+_+_+_+_+_+
+_+_+_+_+_+|             |_+_+_+_+_+_+
+_+_+_+_+_+|             |+_+_+_+_+_+_

+_+_+_+_+_+_+_+_+_+_+_+_+_+_+_+_+_+_+_
+_+_+_+_+_+_+_+_+_+_+_+_+_+_+_+_+_+_+_
+_+_+_+_+_+_+_+_+_+_+_+_+_+_+_+_+_+_+_
+_+_+_+_+_+_+_+_+_+_+_+_+_+_+_+_+_+_+_
+_+_+_+_+_+_+_+_+_+_+_+_+_+_+_+_+_+_+_
______________________________________
                                      
                                      
                                      
                                      
______________________________________
+_+_+_+_+_+_+_+_+_+_+_+_+_+_+_+_+_+_+_
+_+_+_+_+_+_+_+_+_+_+_+_+_+_+_+_+_+_+_
+_+_+_+_+_+_+_+_+_+_+_+_+_+_+_+_+_+_+_
+_+_+_+_+_+_+_+_+_+_+_+_+_+_+_+_+_+_+_
+_+_+_+_+_+_+_+_+_+_+_+_+_+_+_+_+_+_+_

+_+_+_+_+_+_+_+_+_+_+_+_+_+_+_+_+_+_+_
|_+_+_+_+_+|             |_+_+_+_+_+_|
|_+_+_+_+_+|             |_+_+_+_+_+_|
|_+_+_+_+_+|             |_+_+_+_+_+_|
|_+_+_+_+_+|             |_+_+_+_+_+_|
|_+_+_+_+_+|             |___________|
|_+_+_+_+_+|                          
|_+_+_+_+_+|                          
|_+_+_+_+_+|                          
|_+_+_+_+_+|                          
|_+_+_+_+_+|__________________________
+_+_+_+_+_+_+_+_+_+_+_+_+_+_+_+_+_+_+_
+_+_+_+_+_+_+_+_+_+_+_+_+_+_+_+_+_+_+_
+_+_+_+_+_+_+_+_+_+_+_+_+_+_+_+_+_+_+_
+_+_+_+_+_+_+_+_+_+_+_+_+_+_+_+_+_+_+_
+_+_+_+_+_+_+_+_+_+_+_+_+_+_+_+_+_+_+_

+_+_+_+_+_+|             |_+_+_+_+_+_+
+_+_+_+_+_+|             |_+_+_+_+_+_+
+_+_+_+_+_+|             |_+_+_+_+_+_+
+_+_+_+_+_+|             |_+_+_+_+_+_+
+_+_+_+_+_+|             |_+_+_+_+_+_+
___________|             |_+_+_+_+_+_+
                         |_+_+_+_+_+_+
                         |_+_+_+_+_+_+
                         |_+_+_+_+_+_+
                         |_+_+_+_+_+_+
_________________________|_+_+_+_+_+_+
+_+_+_+_+_+_+_+_+_+_+_+_+_+_+_+_+_+_+_
+_+_+_+_+_+_+_+_+_+_+_+_+_+_+_+_+_+_+_
+_+_+_+_+_+_+_+_+_+_+_+_+_+_+_+_+_+_+_
+_+_+_+_+_+_+_+_+_+_+_+_+_+_+_+_+_+_+_
+_+_+_+_+_+_+_+_+_+_+_+_+_+_+_+_+_+_+_

+_+_+_+_+_+_+_+_+_+_+_+_+_+_+_+_+_+_+_
+_+_+_+_+_+_+_+_+_+_+_+_+_+_+_+_+_+_+_
+_+_+_+_+_+_+_+_+_+_+_+_+_+_+_+_+_+_+_
+_+_+_+_+_+_+_+_+_+_+_+_+_+_+_+_+_+_+_
+_+_+_+_+_+_+_+_+_+_+_+_+_+_+_+_+_+_+_
_________________________ +_+_+_+_+_+_
                         |+_+_+_+_+_+_
                         |+_+_+_+_+_+_
                         |+_+_+_+_+_+_
                         |+_+_+_+_+_+_
___________              |+_+_+_+_+_+_
+_+_+_+_+_+|             |+_+_+_+_+_+_
+_+_+_+_+_+|             |+_+_+_+_+_+_
+_+_+_+_+_+|             |+_+_+_+_+_+_
+_+_+_+_+_+|             |+_+_+_+_+_+_
+_+_+_+_+_+|             |+_+_+_+_+_+_

+_+_+_+_+_+_+_+_+_+_+_+_+_+_+_+_+_+_+_
+_+_+_+_+_+_+_+_+_+_+_+_+_+_+_+_+_+_+_
+_+_+_+_+_+_+_+_+_+_+_+_+_+_+_+_+_+_+_
+_+_+_+_+_+_+_+_+_+_+_+_+_+_+_+_+_+_+_
+_+_+_+_+_+_+_+_+_+_+_+_+_+_+_+_+_+_+_
+_+_+_+_+_+___________________________
+_+_+_+_+_+|                          
+_+_+_+_+_+|                          
+_+_+_+_+_+|                          
+_+_+_+_+_+|                          
+_+_+_+_+_+|             _____________
+_+_+_+_+_+|             |+_+_+_+_+_+_
+_+_+_+_+_+|             |+_+_+_+_+_+_
+_+_+_+_+_+|             |+_+_+_+_+_+_
+_+_+_+_+_+|             |+_+_+_+_+_+_
+_+_+_+_+_+|             |+_+_+_+_+_+_

+_+_+_+_+_+|             |+_+_+_+_+_+_
+_+_+_+_+_+|             |_+_+_+_+_+_+
+_+_+_+_+_+|             |_+_+_+_+_+_+
+_+_+_+_+_+|             |_+_+_+_+_+_+
+_+_+_+_+_+|             |_+_+_+_+_+_+
___________|             |____________
                                      
                                      
                                      
                                      
___________               ____________
+_+_+_+_+_+|             |_+_+_+_+_+_+
+_+_+_+_+_+|             |_+_+_+_+_+_+
+_+_+_+_+_+|             |_+_+_+_+_+_+
+_+_+_+_+_+|             |_+_+_+_+_+_+
+_+_+_+_+_+|             |+_+_+_+_+_+_

+_+_+_+_+_+|             |_+_+_+_+_+_+_
+_+_+_+_+_+|             |_+_+_+_+_+_+
+_+_+_+_+_+|             |_+_+_+_+_+_+
+_+_+_+_+_+|             |_+_+_+_+_+_+
+_+_+_+_+_+|             |_+_+_+_+_+_+
___________|             |____________
                                      
                                      
                                      
                                      
______________________________________
+_+_+_+_+_+_+_+_+_+_+_+_+_+_+_+_+_+_+_
+_+_+_+_+_+_+_+_+_+_+_+_+_+_+_+_+_+_+_
+_+_+_+_+_+_+_+_+_+_+_+_+_+_+_+_+_+_+_
+_+_+_+_+_+_+_+_+_+_+_+_+_+_+_+_+_+_+_
+_+_+_+_+_+_+_+_+_+_+_+_+_+_+_+_+_+_+_

+_+_+_+_+_+_+_+_+_+_+_+_+_+_+_+_+_+_+_
+_+_+_+_+_+_+_+_+_+_+_+_+_+_+_+_+_+_+_
+_+_+_+_+_+_+_+_+_+_+_+_+_+_+_+_+_+_+_
+_+_+_+_+_+_+_+_+_+_+_+_+_+_+_+_+_+_+_
+_+_+_+_+_+_+_+_+_+_+_+_+_+_+_+_+_+_+_
______________________________________
                                      
                                      
                                      
                                      
___________               ____________
+_+_+_+_+_+|             |_+_+_+_+_+_+
+_+_+_+_+_+|             |_+_+_+_+_+_+
+_+_+_+_+_+|             |_+_+_+_+_+_+
+_+_+_+_+_+|             |_+_+_+_+_+_+
+_+_+_+_+_+|             |+_+_+_+_+_+_

+_+_+_+_+_+|             |_+_+_+_+_+_+
+_+_+_+_+_+|             |_+_+_+_+_+_+
+_+_+_+_+_+|             |_+_+_+_+_+_+
+_+_+_+_+_+|             |_+_+_+_+_+_+
+_+_+_+_+_+|             |_+_+_+_+_+_+
+_+_+_+_+_+|             |____________
+_+_+_+_+_+|                          
+_+_+_+_+_+|                          
+_+_+_+_+_+|                          
+_+_+_+_+_+|                          
+_+_+_+_+_+|              ____________
+_+_+_+_+_+|             |_+_+_+_+_+_+
+_+_+_+_+_+|             |_+_+_+_+_+_+
+_+_+_+_+_+|             |_+_+_+_+_+_+
+_+_+_+_+_+|             |_+_+_+_+_+_+
+_+_+_+_+_+|             |+_+_+_+_+_+_

+_+_+_+_+_+|             |_+_+_+_+_+_+
+_+_+_+_+_+|             |_+_+_+_+_+_+
+_+_+_+_+_+|             |_+_+_+_+_+_+
+_+_+_+_+_+|             |_+_+_+_+_+_+
+_+_+_+_+_+|             |_+_+_+_+_+_+
___________|             |_+_+_+_+_+_+
                         |_+_+_+_+_+_+
                         |_+_+_+_+_+_+
                         |_+_+_+_+_+_+
                         |_+_+_+_+_+_+
___________              |_+_+_+_+_+_+
+_+_+_+_+_+|             |_+_+_+_+_+_+
+_+_+_+_+_+|             |_+_+_+_+_+_+
+_+_+_+_+_+|             |_+_+_+_+_+_+
+_+_+_+_+_+|             |_+_+_+_+_+_+
+_+_+_+_+_+|             |+_+_+_+_+_+_

......................................
......................................
......................................
......................................
......................................
......................................
......................................
......................................
......................................
......................................
......................................
../============I______I============\..
./================================= \.
|_+_+_+_+_+_+_+_+_+_+_+_+_+_+_+_+_+_+|
|+_+_+_+_+_+_+_+_+_+_+_+_+_+_+_+_+_+_|
|_+_+_+_+_+_+_+_+_+_+_+_+_+_+_+_+_+_+|

......................................
......................................
......................................
......................................
......................................
......................................
......................................
......................................
......................................
.............\........../.............
..............\......../..............
../============I......I============\..
./================================= \.
|_+_+_+_+_+_+_+_+_+_+_+_+_+_+_+_+_+_+|
|+_+_+_+_+_+_+_+_+_+_+_+_+_+_+_+_+_+_|
|_+_+_+_+_+_+_+_+_+_+_+_+_+_+_+_+_+_+|

......................................
......................................
......................................
......................................
......................................
......................................
......................................
......................................
......................................
......................................
......................................
......................................
......................................
......................................
......................................
......................................
