......................................
......................................
......................................
......................................
......................................
......................................
......................................
......................................
......................................
......................................
......................................
../============I______I============\..
./================================= \.
|_+_+_+_+_+_+_+_+_+_+_+_+_+_+_+_+_+_+|
|+_+_+_+_+_+_+_+_+_+_+_+_+_+_+_+_+_+_|
|_+_+_+_+_+_+_+_+_+_+_+_+_+_+_+_+_+_+|

......................................
......................................
......................................
......................................
......................................
......................................
......................................
......................................
......................................
.............\........../.............
..............\......../..............
../============I......I============\..
./================================= \.
|_+_+_+_+_+_+_+_+_+_+_+_+_+_+_+_+_+_+|
|+_+_+_+_+_+_+_+_+_+_+_+_+_+_+_+_+_+_|
|_+_+_+_+_+_+_+_+_+_+_+_+_+_+_+_+_+_+|

|####################################|
|....................................|
|....................................|
|....................................|
|....................................|
|....................................|
|....................................|
|....................................|
|....................................|
|....................................|
|....................................|
|....................................|
|....................................|
|....................................|
|....................................|
|####################################|

xxxxxxxxxxxxxxxxxxxxxxxxxxxxxxxxxxxxxx
xxxxxxxxxxxxxxxxxxxxxxxxxxxxxxxxxxxxxx
xxxxxxxxxxxxxxxxxxxxxxxxxxxxxxxxxxxxxx
xxxxxxxxxxxxxxxxxxxxxxxxxxxxxxxxxxxxxx
xxxxxxxxxxxxxxxxxxxxxxxxxxxxxxxxxxxxxx
xxxxxxxxxxxxxxxxxxxxxxxxxxxxxxxxxxxxxx
xxxxxxxxxxxxxxxxxxxxxxxxxxxxxxxxxxxxxx
xxxxxxxxxxxxxxxxxxxxxxxxxxxxxxxxxxxxxx
xxxxxxxxxxxxxxxxxxxxxxxxxxxxxxxxxxxxxx
xxxxxxxxxxxxxxxxxxxxxxxxxxxxxxxxxxxxxx
xxxxxxxxxxxxxxxxxxxxxxxxxxxxxxxxxxxxxx
xxxxxxxxxxxxxxxxxxxxxxxxxxxxxxxxxxxxxx
xxxxxxxxxxxxxxxxxxxxxxxxxxxxxxxxxxxxxx
xxxxxxxxxxxxxxxxxxxxxxxxxxxxxxxxxxxxxx
xxxxxxxxxxxxxxxxxxxxxxxxxxxxxxxxxxxxxx
xxxxxxxxxxxxxxxxxxxxxxxxxxxxxxxxxxxxxx

......................................
......................................
......................................
......................................
......................................
......................................
......................................
......................................
......................................
......................................
......................................
......................................
......................................
......................................
......................................
......................................
