######################################
######################################
######################################
######################################
######################################
######################################
######################################
######################################
######################################
######################################
######################################
######################################
######################################
######################################
######################################
######################################

+_+_+_+_+_+|             |+_+_+_+_+_+_
+_+_+_+_+_+|             |_+_+_+_+_+_+
+_+_+_+_+_+|             |_+_+_+_+_+_+
+_+_+_+_+_+|             |_+_+_+_+_+_+
+_+_+_+_+_+|             |_+_+_+_+_+_+
+_+_+_+_+_+|             |_+_+_+_+_+_+
+_+_+_+_+_+|             |_+_+_+_+_+_+
+_+_+_+_+_+|             |_+_+_+_+_+_+
+_+_+_+_+_+|             |_+_+_+_+_+_+
+_+_+_+_+_+|             |_+_+_+_+_+_+
+_+_+_+_+_+|             |_+_+_+_+_+_+
+_+_+_+_+_+|             |_+_+_+_+_+_+
+_+_+_+_+_+|             |_+_+_+_+_+_+
+_+_+_+_+_+|             |_+_+_+_+_+_+
+_+_+_+_+_+|             |_+_+_+_+_+_+
+_+_+_+_+_+|             |+_+_+_+_+_+_

+_+_+_+_+_+_+_+_+_+_+_+_+_+_+_+_+_+_+_
+_+_+_+_+_+_+_+_+_+_+_+_+_+_+_+_+_+_+_
+_+_+_+_+_+_+_+_+_+_+_+_+_+_+_+_+_+_+_
+_+_+_+_+_+_+_+_+_+_+_+_+_+_+_+_+_+_+_
+_+_+_+_+_+_+_+_+_+_+_+_+_+_+_+_+_+_+_
______________________________________
                                      
                                      
                                      
                                      
______________________________________
+_+_+_+_+_+_+_+_+_+_+_+_+_+_+_+_+_+_+_
+_+_+_+_+_+_+_+_+_+_+_+_+_+_+_+_+_+_+_
+_+_+_+_+_+_+_+_+_+_+_+_+_+_+_+_+_+_+_
+_+_+_+_+_+_+_+_+_+_+_+_+_+_+_+_+_+_+_
+_+_+_+_+_+_+_+_+_+_+_+_+_+_+_+_+_+_+_

+_+_+_+_+_+|             |+_+_+_+_+_+_
|_+_+_+_+_+|             |_+_+_+_+_+_+
|_+_+_+_+_+|             |_+_+_+_+_+_+
|_+_+_+_+_+|             |_+_+_+_+_+_+
|_+_+_+_+_+|             |_+_+_+_+_+_+
|_+_+_+_+_+|             |____________
|_+_+_+_+_+|                          
|_+_+_+_+_+|                          
|_+_+_+_+_+|                          
|_+_+_+_+_+|                          
|_+_+_+_+_+|__________________________
+_+_+_+_+_+_+_+_+_+_+_+_+_+_+_+_+_+_+_
+_+_+_+_+_+_+_+_+_+_+_+_+_+_+_+_+_+_+_
+_+_+_+_+_+_+_+_+_+_+_+_+_+_+_+_+_+_+_
+_+_+_+_+_+_+_+_+_+_+_+_+_+_+_+_+_+_+_
+_+_+_+_+_+_+_+_+_+_+_+_+_+_+_+_+_+_+_

+_+_+_+_+_+|             |_+_+_+_+_+_+
+_+_+_+_+_+|             |_+_+_+_+_+_+
+_+_+_+_+_+|             |_+_+_+_+_+_+
+_+_+_+_+_+|             |_+_+_+_+_+_+
+_+_+_+_+_+|             |_+_+_+_+_+_+
___________|             |_+_+_+_+_+_+
                         |_+_+_+_+_+_+
                         |_+_+_+_+_+_+
                         |_+_+_+_+_+_+
                         |_+_+_+_+_+_+
_________________________|_+_+_+_+_+_+
+_+_+_+_+_+_+_+_+_+_+_+_+_+_+_+_+_+_+_
+_+_+_+_+_+_+_+_+_+_+_+_+_+_+_+_+_+_+_
+_+_+_+_+_+_+_+_+_+_+_+_+_+_+_+_+_+_+_
+_+_+_+_+_+_+_+_+_+_+_+_+_+_+_+_+_+_+_
+_+_+_+_+_+_+_+_+_+_+_+_+_+_+_+_+_+_+_

+_+_+_+_+_+_+_+_+_+_+_+_+_+_+_+_+_+_+_
+_+_+_+_+_+_+_+_+_+_+_+_+_+_+_+_+_+_+_
+_+_+_+_+_+_+_+_+_+_+_+_+_+_+_+_+_+_+_
+_+_+_+_+_+_+_+_+_+_+_+_+_+_+_+_+_+_+_
+_+_+_+_+_+_+_+_+_+_+_+_+_+_+_+_+_+_+_
_________________________ +_+_+_+_+_+_
                         |+_+_+_+_+_+_
                         |+_+_+_+_+_+_
                         |+_+_+_+_+_+_
                         |+_+_+_+_+_+_
___________              |+_+_+_+_+_+_
+_+_+_+_+_+|             |+_+_+_+_+_+_
+_+_+_+_+_+|             |+_+_+_+_+_+_
+_+_+_+_+_+|             |+_+_+_+_+_+_
+_+_+_+_+_+|             |+_+_+_+_+_+_
+_+_+_+_+_+|             |+_+_+_+_+_+_

+_+_+_+_+_+_+_+_+_+_+_+_+_+_+_+_+_+_+_
+_+_+_+_+_+_+_+_+_+_+_+_+_+_+_+_+_+_+_
+_+_+_+_+_+_+_+_+_+_+_+_+_+_+_+_+_+_+_
+_+_+_+_+_+_+_+_+_+_+_+_+_+_+_+_+_+_+_
+_+_+_+_+_+_+_+_+_+_+_+_+_+_+_+_+_+_+_
+_+_+_+_+_+___________________________
+_+_+_+_+_+|                          
+_+_+_+_+_+|                          
+_+_+_+_+_+|                          
+_+_+_+_+_+|                          
+_+_+_+_+_+|             _____________
+_+_+_+_+_+|             |+_+_+_+_+_+_
+_+_+_+_+_+|             |+_+_+_+_+_+_
+_+_+_+_+_+|             |+_+_+_+_+_+_
+_+_+_+_+_+|             |+_+_+_+_+_+_
+_+_+_+_+_+|             |+_+_+_+_+_+_

+_+_+_+_+_+|             |+_+_+_+_+_+_
+_+_+_+_+_+|             |_+_+_+_+_+_+
+_+_+_+_+_+|             |_+_+_+_+_+_+
+_+_+_+_+_+|             |_+_+_+_+_+_+
+_+_+_+_+_+|             |_+_+_+_+_+_+
___________|             |____________
                                      
                                      
                                      
                                      
___________               ____________
+_+_+_+_+_+|             |_+_+_+_+_+_+
+_+_+_+_+_+|             |_+_+_+_+_+_+
+_+_+_+_+_+|             |_+_+_+_+_+_+
+_+_+_+_+_+|             |_+_+_+_+_+_+
+_+_+_+_+_+|             |+_+_+_+_+_+_

+_+_+_+_+_+|             |_+_+_+_+_+_+
+_+_+_+_+_+|             |_+_+_+_+_+_+
+_+_+_+_+_+|             |_+_+_+_+_+_+
+_+_+_+_+_+|             |_+_+_+_+_+_+
+_+_+_+_+_+|             |_+_+_+_+_+_+
___________|             |____________
                                      
                                      
                                      
                                      
______________________________________
+_+_+_+_+_+_+_+_+_+_+_+_+_+_+_+_+_+_+_
+_+_+_+_+_+_+_+_+_+_+_+_+_+_+_+_+_+_+_
+_+_+_+_+_+_+_+_+_+_+_+_+_+_+_+_+_+_+_
+_+_+_+_+_+_+_+_+_+_+_+_+_+_+_+_+_+_+_
+_+_+_+_+_+_+_+_+_+_+_+_+_+_+_+_+_+_+_

+_+_+_+_+_+_+_+_+_+_+_+_+_+_+_+_+_+_+_
+_+_+_+_+_+_+_+_+_+_+_+_+_+_+_+_+_+_+_
+_+_+_+_+_+_+_+_+_+_+_+_+_+_+_+_+_+_+_
+_+_+_+_+_+_+_+_+_+_+_+_+_+_+_+_+_+_+_
+_+_+_+_+_+_+_+_+_+_+_+_+_+_+_+_+_+_+_
______________________________________
                                      
                                      
                                      
                                      
___________               ____________
+_+_+_+_+_+|             |_+_+_+_+_+_+
+_+_+_+_+_+|             |_+_+_+_+_+_+
+_+_+_+_+_+|             |_+_+_+_+_+_+
+_+_+_+_+_+|             |_+_+_+_+_+_+
+_+_+_+_+_+|             |+_+_+_+_+_+_

+_+_+_+_+_+|             |_+_+_+_+_+_+
+_+_+_+_+_+|             |_+_+_+_+_+_+
+_+_+_+_+_+|             |_+_+_+_+_+_+
+_+_+_+_+_+|             |_+_+_+_+_+_+
+_+_+_+_+_+|             |_+_+_+_+_+_+
+_+_+_+_+_+|             |____________
+_+_+_+_+_+|                          
+_+_+_+_+_+|                          
+_+_+_+_+_+|                          
+_+_+_+_+_+|                          
+_+_+_+_+_+|              ____________
+_+_+_+_+_+|             |_+_+_+_+_+_+
+_+_+_+_+_+|             |_+_+_+_+_+_+
+_+_+_+_+_+|             |_+_+_+_+_+_+
+_+_+_+_+_+|             |_+_+_+_+_+_+
+_+_+_+_+_+|             |+_+_+_+_+_+_

+_+_+_+_+_+|             |_+_+_+_+_+_+
+_+_+_+_+_+|             |_+_+_+_+_+_+
+_+_+_+_+_+|             |_+_+_+_+_+_+
+_+_+_+_+_+|             |_+_+_+_+_+_+
+_+_+_+_+_+|             |_+_+_+_+_+_+
___________|             |_+_+_+_+_+_+
                         |_+_+_+_+_+_+
                         |_+_+_+_+_+_+
                         |_+_+_+_+_+_+
                         |_+_+_+_+_+_+
___________              |_+_+_+_+_+_+
+_+_+_+_+_+|             |_+_+_+_+_+_+
+_+_+_+_+_+|             |_+_+_+_+_+_+
+_+_+_+_+_+|             |_+_+_+_+_+_+
+_+_+_+_+_+|             |_+_+_+_+_+_+
+_+_+_+_+_+|             |+_+_+_+_+_+_

_+_+_+_+_+_+_+_+_+_+_+_+_+_+_+_+_+_+_+
_+_+_+_+_+_+_+_+_+_+_+_+_+_+_+_+_+_+_+
_+_+_+_+_+_+_+_+_+_+_+_+_+_+_+_+_+_+_+
______________________+_+_+_+_+_+_+_+_
                      \+_+_+_+_+_+_+_+
                       \_+_+_+_+_+_+_+
                       |_+_+_+_+_+_+_+
                       |_+_+_+_+_+_+_+
  ___________          |_+_+_+_+_+_+_+
 /_+_+_+_+_+_|         |_+_+_+_+_+_+_+
/+_+_+_+_+_+_|         |_+_+_+_+_+_+_+
+_/============I______I============\_+
+/=============        ============ \+
|==============        ==============|
|==============        ==============|
|==============        ==============|

_+_+_+_+_+_+_+_+_+_+_+_+_+_+_+_+_+_+_+
_+_+_+_+_+_+_+_+_+_+_+_+_+_+_+_+_+_+_+
_+_+_+_+_+_+_+_+_+_+_+_+_+_+_+_+_+_+_+
______________________+_+_+_+_+_+_+_+_
                      \+_+_+_+_+_+_+_+
                       \_+_+_+_+_+_+_+
                       |_+_+_+_+_+_+_+
                       |_+_+_+_+_+_+_+
  ___________          |_+_+_+_+_+_+_+
 /_+_+_+_+_+_|         |_+_+_+_+_+_+_+
/+_+_+_+_+_+_|         |_+_+_+_+_+_+_+
+_/============I      I============\_+
+/=============       |============ \+
|==============       |==============|
|==============        ==============|
|==============        ==============|

+_+_+_+_+_+#             #+_+_+_+_+_+_
+_+_+_+_+_+#             #_+_+_+_+_+_+
+_+_+_+_+_+#             #_+_+_+_+_+_+
+_+_+_+_+_+#             #_+_+_+_+_+_+
+_+_+_+_+_+#             #_+_+_+_+_+_+
############             #############
                                      
                                      
                                      
                                      
############             #############
+_+_+_+_+_+#             #_+_+_+_+_+_+
+_+_+_+_+_+#             #_+_+_+_+_+_+
+_+_+_+_+_+#             #_+_+_+_+_+_+
+_+_+_+_+_+#             #_+_+_+_+_+_+
+_+_+_+_+_+#             #+_+_+_+_+_+_

_+_+_+_+_+_|             |+_+_+_+_+_+_
_+_+_+_+_+_|             |+_+_+_+_+_+_
_+_+_+_+_+_|             |+_+_+_+_+_+_
_+_+_+_+_+_|             |+_+_+_+_+_+_
_+_+_+_+_+_|             |___________ 
_+_+_+_+_/                _______    \
_+_+_+_+|                /_____ /|   |
_+_+_+_+|               |_o__o_| |   |
_+_+_+_+|               |______|/    |
_+_+_+_+|                  __________/
_+_+_+_+_\_               /_+_+_+_+_+_
_+_+_+_+_+_|             |+_+_+_+_+_+_
_+_+_+_+_+_|             |+_+_+_+_+_+_
_+_+_+_+_+_|             |+_+_+_+_+_+_
_+_+_+_+_+_|             |+_+_+_+_+_+_
_+_+_+_+_+_|             |+_+_+_+_+_+_

+_+_+_+_+_+_+_+_+_+_+_+_+_+_+_+_+_+_+_
+_+_+_+_+_____________________+_+_+_+_
+_+_+_+_+/      _______       \_+_+_+_
+_+_+_+_/      /_____ /|       \+_+_+_
+_+_+_+/      |_o__o_| |        \_+_+_
______/       |______|/          \+_+_
                                  \_+_
                                  |_+_
                                  |_+_
                                  |_+_
___________                       |_+_
+_+_+_+_+_+|                      |_+_
+_+_+_+_+_+|                      |_+_
+_+_+_+_+_+|               ______/+_+_
+_+_+_+_+_+|              /_+_+_+_+_+_
+_+_+_+_+_+|             /+_+_+_+_+_+_

+_+_+_+_+_+_+_+_+_+_+_+_+_+_+_+_+_+_+_
+_+_+_+_+_____________________+_+_+_+_
+_+_+_+_+/      _______       \_+_+_+_
+_+_+_+_/      /_____ /|       \+_+_+_
+_+_+_+/      |_o__o_| |        \_+_+_
+_+_+_/       |______|/          _____
+_+_+_\                               
+_+_+_+\                              
+_+_+_+_\                             
+_+_+_+_+\                            
+_+_+_+_+_\                        ___
+_+_+_+_+_+|                      |_+_
+_+_+_+_+_+|                      |_+_
+_+_+_+_+_+|               ______/+_+_
+_+_+_+_+_+|              /_+_+_+_+_+_
+_+_+_+_+_+|             /+_+_+_+_+_+_

+_+_+_+_+_+|             |_+_+_+_+_+_+
+_+_+_+_+_+|             |_+_+_+_+_+_+
+_+_+_+_+_+|             |_+_+_+_+_+_+
+_+_+_+_+_+|             |_+_+_+_+_+_+
+_+_+_+_+_+|             |_+_+_+_+_+_+
___________|             |____________
                                      
                                      
                                      
                                      
________       _________      ________
+_+_+_+_\     /_______ /|    /+_+_+_+_
+_+_+_+_+|   |_/    \_| |   |_+_+_+_+_
+_+_+_+_+_\  |_||||||_|/   /+_+_+_+_+_
+_+_+_+_+_+\______________/_+_+_+_+_+_
+_+_+_+_+_+_+_+_+_+_+_+_+_+_+_+_+_+_+_

YOUWINYOUWINYOUWINYOUWINYOUWINYOUWINYO
YOUWINYOUWINYOUWINYOUWINYOUWINYOUWINYO
YOUWINYOUWINYOUWINYOUWINYOUWINYOUWINYO
YOUWINYOUWINYOUWINYOUWINYOUWINYOUWINYO
YOUWINYOUWINYOUWINYOUWINYOUWINYOUWINYO
YOUWINYOUWINYOUWINYOUWINYOUWINYOUWINYO
YOUWINYOUWINYOUWINYOUWINYOUWINYOUWINYO
YOUWINYOUWINYOUWINYOUWINYOUWINYOUWINYO
YOUWINYOUWINYOUWINYOUWINYOUWINYOUWINYO
YOUWINYOUWINYOUWINYOUWINYOUWINYOUWINYO
YOUWINYOUWINYOUWINYOUWINYOUWINYOUWINYO
YOUWINYOUWINYOUWINYOUWINYOUWINYOUWINYO
YOUWINYOUWINYOUWINYOUWINYOUWINYOUWINYO
YOUWINYOUWINYOUWINYOUWINYOUWINYOUWINYO
YOUWINYOUWINYOUWINYOUWINYOUWINYOUWINYO
YOUWINYOUWINYOUWINYOUWINYOUWINYOUWINYO

......................................
......................................
......................................
......................................
......................................
......................................
......................................
......................................
......................................
......................................
......................................
......................................
......................................
......................................
......................................
......................................
